"filename", "language", "Dart", "comment", "blank", "total"
"d:\Flutter_projects\updated\sds\Mystica\lib\data\local\db\app_db.dart", "Dart", 12, 3, 3, 18
"d:\Flutter_projects\updated\sds\Mystica\lib\screens\submain-screens\album\album_screen.dart", "Dart", 2, 0, 0, 2
"d:\Flutter_projects\updated\sds\Mystica\lib\screens\submain-screens\album\edit_album_screen.dart", "Dart", 74, 2, 4, 80
"d:\Flutter_projects\updated\sds\Mystica\lib\screens\submain-screens\album\image\detail_image_screen.dart", "Dart", 4, 0, 0, 4
"d:\Flutter_projects\updated\sds\Mystica\lib\screens\submain-screens\journal\create_journal_screen.dart", "Dart", 11, -4, 1, 8
"d:\Flutter_projects\updated\sds\Mystica\lib\screens\submain-screens\journal\journal_screen.dart", "Dart", 13, -6, -1, 6
"d:\Flutter_projects\updated\sds\Mystica\lib\screens\submain-screens\notebook\edit_notebook.dart", "Dart", 24, -2, 2, 24
"d:\Flutter_projects\updated\sds\Mystica\lib\screens\submain-screens\notebook\notebook_screen.dart", "Dart", 0, 0, -1, -1
"d:\Flutter_projects\updated\sds\Mystica\lib\screens\submain-screens\reminder\reminder_screen.dart", "Dart", 6, 6, 2, 14
"d:\Flutter_projects\updated\sds\Mystica\lib\screens\submain-screens\todo\todo_screen.dart", "Dart", 4, 2, 2, 8
"d:\Flutter_projects\updated\sds\Mystica\lib\widgets\Items\album_item.dart", "Dart", 1, 0, 0, 1
"Total", "-", 151, 1, 12, 164