"filename", "language", "YAML", "C++", "Dart", "Markdown", "CMake", "comment", "blank", "total"
"d:\Flutter_projects\updated\sds\Mystica\README.md", "Markdown", 0, 0, 0, 10, 0, 0, 7, 17
"d:\Flutter_projects\updated\sds\Mystica\analysis_options.yaml", "YAML", 3, 0, 0, 0, 0, 23, 4, 30
"d:\Flutter_projects\updated\sds\Mystica\lib\data\local\db\app_db.dart", "Dart", 0, 0, 185, 0, 0, 54, 50, 289
"d:\Flutter_projects\updated\sds\Mystica\lib\data\local\db\app_db.g.dart", "Dart", 0, 0, 2386, 0, 0, 2, 99, 2487
"d:\Flutter_projects\updated\sds\Mystica\lib\data\local\entity\album_entity.dart", "Dart", 0, 0, 9, 0, 0, 0, 2, 11
"d:\Flutter_projects\updated\sds\Mystica\lib\data\local\entity\image_entity.dart", "Dart", 0, 0, 10, 0, 0, 0, 2, 12
"d:\Flutter_projects\updated\sds\Mystica\lib\data\local\entity\journal_entity.dart", "Dart", 0, 0, 9, 0, 0, 0, 2, 11
"d:\Flutter_projects\updated\sds\Mystica\lib\data\local\entity\note_entity.dart", "Dart", 0, 0, 10, 0, 0, 0, 2, 12
"d:\Flutter_projects\updated\sds\Mystica\lib\data\local\entity\notebook_entity.dart", "Dart", 0, 0, 9, 0, 0, 0, 2, 11
"d:\Flutter_projects\updated\sds\Mystica\lib\data\local\entity\remainder_entity.dart", "Dart", 0, 0, 8, 0, 0, 0, 2, 10
"d:\Flutter_projects\updated\sds\Mystica\lib\data\local\entity\todo_entity.dart", "Dart", 0, 0, 7, 0, 0, 0, 2, 9
"d:\Flutter_projects\updated\sds\Mystica\lib\data\local\entity\user_entity.dart", "Dart", 0, 0, 7, 0, 0, 0, 2, 9
"d:\Flutter_projects\updated\sds\Mystica\lib\main.dart", "Dart", 0, 0, 81, 0, 0, 9, 4, 94
"d:\Flutter_projects\updated\sds\Mystica\lib\models\Gallery\Album.dart", "Dart", 0, 0, 15, 0, 0, 0, 3, 18
"d:\Flutter_projects\updated\sds\Mystica\lib\models\Gallery\ImageAttr.dart", "Dart", 0, 0, 13, 0, 0, 0, 2, 15
"d:\Flutter_projects\updated\sds\Mystica\lib\models\Journal\Journal.dart", "Dart", 0, 0, 14, 0, 0, 0, 2, 16
"d:\Flutter_projects\updated\sds\Mystica\lib\models\Notebook\Note.dart", "Dart", 0, 0, 16, 0, 0, 0, 2, 18
"d:\Flutter_projects\updated\sds\Mystica\lib\models\Notebook\Notebook.dart", "Dart", 0, 0, 14, 0, 0, 0, 2, 16
"d:\Flutter_projects\updated\sds\Mystica\lib\models\reminder\reminder.dart", "Dart", 0, 0, 12, 0, 0, 0, 2, 14
"d:\Flutter_projects\updated\sds\Mystica\lib\models\todo\todo.dart", "Dart", 0, 0, 12, 0, 0, 0, 2, 14
"d:\Flutter_projects\updated\sds\Mystica\lib\screens\main-screen\get_started_screen.dart", "Dart", 0, 0, 50, 0, 0, 5, 2, 57
"d:\Flutter_projects\updated\sds\Mystica\lib\screens\main-screen\home_screen.dart", "Dart", 0, 0, 374, 0, 0, 5, 5, 384
"d:\Flutter_projects\updated\sds\Mystica\lib\screens\main-screen\login_screen.dart", "Dart", 0, 0, 329, 0, 0, 27, 12, 368
"d:\Flutter_projects\updated\sds\Mystica\lib\screens\main-screen\profile_screen.dart", "Dart", 0, 0, 274, 0, 0, 16, 9, 299
"d:\Flutter_projects\updated\sds\Mystica\lib\screens\main-screen\signup_screen.dart", "Dart", 0, 0, 295, 0, 0, 19, 11, 325
"d:\Flutter_projects\updated\sds\Mystica\lib\screens\submain-screens\album\album_screen.dart", "Dart", 0, 0, 228, 0, 0, 17, 12, 257
"d:\Flutter_projects\updated\sds\Mystica\lib\screens\submain-screens\album\create_album_screen.dart", "Dart", 0, 0, 149, 0, 0, 10, 17, 176
"d:\Flutter_projects\updated\sds\Mystica\lib\screens\submain-screens\album\edit_album_screen.dart", "Dart", 0, 0, 172, 0, 0, 5, 10, 187
"d:\Flutter_projects\updated\sds\Mystica\lib\screens\submain-screens\album\image\add_image_screen.dart", "Dart", 0, 0, 130, 0, 0, 5, 17, 152
"d:\Flutter_projects\updated\sds\Mystica\lib\screens\submain-screens\album\image\detail_image_screen.dart", "Dart", 0, 0, 140, 0, 0, 2, 7, 149
"d:\Flutter_projects\updated\sds\Mystica\lib\screens\submain-screens\album\image\image_screen.dart", "Dart", 0, 0, 401, 0, 0, 27, 10, 438
"d:\Flutter_projects\updated\sds\Mystica\lib\screens\submain-screens\journal\create_journal_screen.dart", "Dart", 0, 0, 167, 0, 0, 2, 13, 182
"d:\Flutter_projects\updated\sds\Mystica\lib\screens\submain-screens\journal\detail_journal_screen.dart", "Dart", 0, 0, 130, 0, 0, 1, 4, 135
"d:\Flutter_projects\updated\sds\Mystica\lib\screens\submain-screens\journal\edit_journal_screen.dart", "Dart", 0, 0, 171, 0, 0, 6, 13, 190
"d:\Flutter_projects\updated\sds\Mystica\lib\screens\submain-screens\journal\journal_screen.dart", "Dart", 0, 0, 333, 0, 0, 12, 13, 358
"d:\Flutter_projects\updated\sds\Mystica\lib\screens\submain-screens\notebook\create_notebook_screen.dart", "Dart", 0, 0, 186, 0, 0, 1, 14, 201
"d:\Flutter_projects\updated\sds\Mystica\lib\screens\submain-screens\notebook\edit_notebook.dart", "Dart", 0, 0, 181, 0, 0, 4, 14, 199
"d:\Flutter_projects\updated\sds\Mystica\lib\screens\submain-screens\notebook\note\create_note.dart", "Dart", 0, 0, 190, 0, 0, 1, 15, 206
"d:\Flutter_projects\updated\sds\Mystica\lib\screens\submain-screens\notebook\note\detail_note_screen.dart", "Dart", 0, 0, 127, 0, 0, 1, 6, 134
"d:\Flutter_projects\updated\sds\Mystica\lib\screens\submain-screens\notebook\note\edit_note_screen.dart", "Dart", 0, 0, 171, 0, 0, 1, 12, 184
"d:\Flutter_projects\updated\sds\Mystica\lib\screens\submain-screens\notebook\note\note_screen.dart", "Dart", 0, 0, 115, 0, 0, 0, 8, 123
"d:\Flutter_projects\updated\sds\Mystica\lib\screens\submain-screens\notebook\notebook_screen.dart", "Dart", 0, 0, 332, 0, 0, 14, 15, 361
"d:\Flutter_projects\updated\sds\Mystica\lib\screens\submain-screens\reminder\reminder_screen.dart", "Dart", 0, 0, 351, 0, 0, 19, 16, 386
"d:\Flutter_projects\updated\sds\Mystica\lib\screens\submain-screens\todo\todo_screen.dart", "Dart", 0, 0, 347, 0, 0, 20, 17, 384
"d:\Flutter_projects\updated\sds\Mystica\lib\screens\testing.dart", "Dart", 0, 0, 86, 0, 0, 6, 7, 99
"d:\Flutter_projects\updated\sds\Mystica\lib\widgets\Items\add_reminder.dart", "Dart", 0, 0, 92, 0, 0, 5, 9, 106
"d:\Flutter_projects\updated\sds\Mystica\lib\widgets\Items\add_task.dart", "Dart", 0, 0, 51, 0, 0, 0, 9, 60
"d:\Flutter_projects\updated\sds\Mystica\lib\widgets\Items\album_item.dart", "Dart", 0, 0, 72, 0, 0, 2, 5, 79
"d:\Flutter_projects\updated\sds\Mystica\lib\widgets\Items\image_item.dart", "Dart", 0, 0, 71, 0, 0, 30, 6, 107
"d:\Flutter_projects\updated\sds\Mystica\lib\widgets\Items\journal_item.dart", "Dart", 0, 0, 119, 0, 0, 3, 7, 129
"d:\Flutter_projects\updated\sds\Mystica\lib\widgets\Items\new_image.dart", "Dart", 0, 0, 62, 0, 0, 2, 8, 72
"d:\Flutter_projects\updated\sds\Mystica\lib\widgets\Items\note_item.dart", "Dart", 0, 0, 148, 0, 0, 1, 6, 155
"d:\Flutter_projects\updated\sds\Mystica\lib\widgets\Items\notebook_item.dart", "Dart", 0, 0, 171, 0, 0, 3, 10, 184
"d:\Flutter_projects\updated\sds\Mystica\lib\widgets\Items\reminder_item.dart", "Dart", 0, 0, 149, 0, 0, 8, 7, 164
"d:\Flutter_projects\updated\sds\Mystica\lib\widgets\Items\todo_item.dart", "Dart", 0, 0, 123, 0, 0, 15, 7, 145
"d:\Flutter_projects\updated\sds\Mystica\lib\widgets\navigation.dart", "Dart", 0, 0, 248, 0, 0, 2, 5, 255
"d:\Flutter_projects\updated\sds\Mystica\pubspec.yaml", "YAML", 43, 0, 0, 0, 0, 55, 14, 112
"d:\Flutter_projects\updated\sds\Mystica\windows\flutter\generated_plugin_registrant.cc", "C++", 0, 6, 0, 0, 0, 4, 5, 15
"d:\Flutter_projects\updated\sds\Mystica\windows\flutter\generated_plugin_registrant.h", "C++", 0, 5, 0, 0, 0, 5, 6, 16
"d:\Flutter_projects\updated\sds\Mystica\windows\flutter\generated_plugins.cmake", "CMake", 0, 0, 0, 0, 19, 0, 6, 25
"d:\Flutter_projects\updated\sds\Mystica\windows\runner\flutter_window.cpp", "C++", 0, 45, 0, 0, 0, 4, 13, 62
"d:\Flutter_projects\updated\sds\Mystica\windows\runner\flutter_window.h", "C++", 0, 20, 0, 0, 0, 5, 9, 34
"d:\Flutter_projects\updated\sds\Mystica\windows\runner\main.cpp", "C++", 0, 30, 0, 0, 0, 4, 10, 44
"d:\Flutter_projects\updated\sds\Mystica\windows\runner\resource.h", "C++", 0, 9, 0, 0, 0, 6, 2, 17
"d:\Flutter_projects\updated\sds\Mystica\windows\runner\utils.cpp", "C++", 0, 53, 0, 0, 0, 2, 10, 65
"d:\Flutter_projects\updated\sds\Mystica\windows\runner\utils.h", "C++", 0, 8, 0, 0, 0, 6, 6, 20
"d:\Flutter_projects\updated\sds\Mystica\windows\runner\win32_window.cpp", "C++", 0, 183, 0, 0, 0, 15, 48, 246
"d:\Flutter_projects\updated\sds\Mystica\windows\runner\win32_window.h", "C++", 0, 48, 0, 0, 0, 29, 22, 99
"Total", "-", 46, 407, 9552, 10, 19, 520, 704, 11258